16x24
XXXXXXXXXXXXXXXX
XXXXXXXXXXXXXXXX
||||||||||||||||
||||||||||||||||
}FTFTFT{}TFTFTF{
}FFFFFF{}FFFFFF{
}\||||/{}\||||/{
}\||||/{}\||||/{
}FTFTFT{}TFTFTF{
}FFFFFF{}FFFFFF{
}\||||/{}\||||/{
}\||||/{}\||||/{
}FTFTFT{}TFTFTF{
}FFFFFF{}FFFFFF{
}\||||/{}\||||/{
}\||||/{}\||||/{
}FTFTFT{}TFTFTF{
}FFFFFF{}FFFFFF{
~~~~~~~~~~~~~~~~
~~~~~~~~~~~~~~~~
++++++++++++++++
++++++++++++++++
++++++++++++++++
++++++++++++++++