16x15
+||||||||||||||+
+||||||||||||||+
+||||||DD||||||+
GGGGGGG{}GGGGGGG
GGGGGGG{}GGGGGGG
GGGGGGG{}GGGGGGG
GGGGGGG{}GGGGGGG
GGGGGGG{}GGGGGGG
GGGGGGG{}GGGGGGG
GGGGGGG{}GGGGGGG
GGGGGGG{}GGGGGGG
++++++++++++++++
++++++++++++++++
++++++++++++++++
||||||||||||||||