~~~~~~~~~~~~~~~~~
~~~~~~~~~~~~~~~~~
~~~GGGGGG~~~~~~~~
~~GGGGGGGG~~~~~~~
~~GGGGGGGG~~~~~~~
~~GGGGGGGG~~~~~~~
~~~GGGGGG~~~~~~~~
~~~~~~~~~~~+~~~~~
~~~~~~~~~~++~~~~~
~~~~~~~~~++++~~~~
~~~~~~~~~+||/~~~~
~~~~~~~~~V|D/~~~
~~~~~~~~~V~~~~~~~
~~~~~~~~~~~~~~~~~
~~~~~~~~~~~~~~~~~