16x22
~~~~~~~~~~~~~~~~
~~~~~~~~~~~~~~~~
~~~~~~~~~~~~~~~~
~~~~~~~~~~~~~~~~
GGGGGGGGGGGGGGGG
GGTGGGGTGGGGGGGG
GGGGTGGGGGGGGGGG
GGGGGGGGGGGGGGGG
GGGGGGGGGGGGTTGG
GGTGGGGTTGGGGGGG
GGGGGGGGTGGGGGGG
GGGGTGGGGGGGGGGG
GGGGTGGGGGGGGGGG
GGGGGGGGGGGGGGGG
GGGGGGGGGGGGGTGG
GGGTTGGGGGGGGGGG
GGGGGGGGGGGGGGGG
GGGGGGGGGGGTGGGG
GGGGGGGGGGGGGGGG
GGGGGGTGGGGGGTGG
GGGGGGGGGGGGTGGG
GGTGGGGGGGGGGGGG