16x15
GGGTGTG{}GTGTTTG
TTTTGTG{}GTTTTTT
TGTTGTG{}GTTGTTT
TTTTTTG{}GTGTTGT
TTGTTTG{}GTTTGTT
TGTTTTG{}GTTGGTT
TGGTGTG{}GTTTTGT
TTTTTTG{}GTGTTTT
TTGTTTG{}GTTTTGT
TTTGTTG{}GTTGTTG
TTGTTGG{}GTTTTTT
TGTGTTG{}GTTTTGT
TTTTGTG{}GTTGTTT
TGTTTTG{}GTTTTTG
TGGTGTG{}GTGGGTT