16x15
WWWWWWWFFWWWWWWW
WWWWFFFFFFFFWWWW
WWFRFFFFFFFFFFWW
WWFFFFFGFFFFRFWW
WFFFFFFFFFFGFFFW
WFFFGFFGFFFFFFFW
WFFFFFFFFFGFFFFW
FFFFFFFFFFHFFFFF
FFFFFFGFFFFFFFFF
WFRFFFFFFFFFFGFW
WFFFFFFGFFFFFFFW
WWFRRFFFFFGFFFWW
WWFFFFFFFFFRFFWW
WWWWFFFFFFFFWWWW
WWWWWWWFFWWWWWWW