16x15
XXXXXXXXXXXXXXXX
XXXXXXXXXXXXXXXX
XXXXXXXXXXXXXXXX
X||||||||||||||X
/||||||||||||||\
/FFFFFFFFFFFFFF\
FFFFFFFFFFFFFFFF
~~~~~~~~~~~~~~~~
~~~~~~~~~~~~~~~~
FFFFFFFFFFFFFFFF
XFFFFFFFFFFFFFFX
XXXXXXXXXXXXXXXX
XXXXXXXXXXXXXXXX
XXXXXXXXXXXXXXXX
XXXXXXXXXXXXXXXX