16x15
||XXXXXXXXXXXXXX
||X||||||||||||X
FFX||||||||||||X
FFXFCCFFFFFFCFFX
FFXFFFFFFFFFFFFX
FFXFFCFFFFFFFFFX
FFXFFFFFFTFTFFFX
FFXFFFFFFFFFFFFX
FFXFCFFFFFFCFFFX
FFXFFFFFFFFFCFFX
FFXXXXXXXXXXXXXX
FF\||||||||||||X
FF\||||||D|||||X
FFFFFFFFFFFFFFFF
FFFFFFFFFFFFFFFF