16x15
XXXXXXXXXXXXXXXX
XX||||||||||||XX
XX||||||||||||XX
XX||||||||||||XX
XXFFFFFFFFFCFFXX
XXFFCFFFFFFFFFXX
XXFFFFFFTFTFFFXX
XXFFFFFFFFFCFFXX
XXFFCFFFFFFFFFXX
XXFFFFFFFFFCCFXX
XXXXXXXXXXXXXXXXX
||||||||||||||||
||||||||D|||||||
FFFFFFFFFFFFFFFF
FFFFFFFFFFFFFFFF