16x15
XXXXXXXXXXXXXXXX
XXXXXXXXXXXXXXXX
XXXXXXXXXXXXXXXX
XXXX||||||||||||
XXXX||||||||||||
XXXXFCFFFFFFFFFF
XXXXFFFFFFFCFFFF
XXXXFFFCFFFFFFFF
XXXXFFFFFFFFFFFF
XXXXFFFFFFFFFCFF
XXXXFFFFTFTFFFFF
XXXXFFFFFFFFFFFF
XXXXFFFFFFFFFFFF
XXXXFFFFFFFFFFFF
XXXXFFFFFFFFFFFF