16x22
X||||||||||||||X
X||||||||||||||X
X||||||||||||||X
XFFFFFTFFTFFFFFX
/FFFFFFFFFFFFFF\
/FFFFFF{}FFFFFF\
/FFF+FF{}FF+FFF\
FFFFVFF{}FFVFFFF
~~~FVFF{}FFVF~~~
~~~FFFF{}FFFF~~~
FFFF+FF{}FF+FFFF
FFFFVFF{}FFVFFFF
~~~FVFF{}FFVF~~~
~~~FFFF{}FFFF~~~
FFF+FFF{}FFF+FFF
FFFVFFF{}FFFVFFF
~~~VFFF{}FFFV~~~
~~~FFFF{}FFFF~~~
FFF+FFF{}FFF+FFF
FFFVFFF{}FFFVFFF
FFFVFFF{}FFFVFFF
FFFFFFF{}FFFFFFF